13
0 0 74
68 19 59 -49 -69 59 57 19 -38 -23 -69 -19 69
-39 35 3 32 -4 26 17 64 4 23 21 -13 -42
68 -15 -65 -1 4 63 63 -72 48 12 48 -28 35
68 -43 -19 -34 31 -73 -35 -68 32 27 -27 -43 71
-56 22 32 -40 41 -11 45 -44 -2 26 50 -37 24
-13 -11 52 18 0 24 12 -13 42 -63 55 48 7
62 -26 1 31 32 45 39 -62 -47 61 19 -59 4
52 49 34 16 -36 62 -37 -27 71 -66 -31 19 -70
1 -13 -55 40 -36 -58 -18 -16 20 65 -36 -52 71
-68 -5 -42 -52 11 0 53 48 -68 53 42 50 -4
-1 -28 -44 58 37 24 -20 5 -13 68 0 -67 -56
66 11 -39 -21 59 37 -22 -13 -36 19 -29 48 -49
-58 54 40 -2 -16 -42 22 25 -73 0 -29 18 22
