15
0 0 42
20 2 -28 4 6 0 -1 27 22 -36 21 -41 40 -1 17
25 -29 -21 -35 0 22 1 -35 36 -5 15 -17 3 -16 26
6 -34 -28 34 -36 -33 34 -37 16 -12 -29 -37 -10 -27 36
27 8 -23 -7 -1 23 -27 3 -16 -22 -6 -29 37 9 -1
22 -15 -35 6 5 30 39 -39 23 13 10 9 6 20 36
40 -3 -1 -21 -10 -2 0 -38 -3 -14 -16 8 1 -11 -17
2 -31 31 -36 38 -36 22 35 -32 3 -5 -40 -12 -9 16
5 -8 19 -4 27 -28 -6 26 -22 8 40 -38 -16 40 -5
31 40 -37 20 32 31 13 12 -22 1 -16 -27 -39 26 -37
11 29 -1 -30 33 28 -14 -38 12 -36 -4 -9 -30 18 5
-36 7 -1 -29 26 34 -18 37 4 38 -38 -18 -24 -33 1
-17 -2 -30 16 -32 20 2 -3 14 13 -39 18 22 28 -36
25 20 -41 26 5 -25 18 -21 -20 21 -17 -14 39 39 5
-40 -14 7 29 30 -38 -5 31 -41 19 2 -36 35 22 -22
27 5 -40 -26 29 1 10 -4 22 30 25 40 -3 22 37
