8
0 0 12
-6 10 -12 3 -9 10 0 7
1 -5 6 -10 10 -12 11 -7
-11 -3 3 -8 4 -4 3 -11
9 -4 -5 -11 -4 -9 -2 -6
9 -4 0 0 6 5 9 0
-7 -5 5 7 1 11 4 1
8 -7 -12 4 4 -8 11 -7
7 -3 7 -4 -7 -11 5 -5
