14
0 0 42
6 -23 -31 13 -23 -14 34 37 -31 7 16 -21 -31 -20
-14 -28 19 -23 -28 -5 34 -37 -14 -19 29 -32 -23 -14
21 -11 23 10 5 -9 -9 28 -24 21 -34 -13 -15 -30
8 40 -25 4 -6 -2 6 34 2 -6 -39 28 33 36
38 -7 8 14 -12 -42 -23 13 23 -29 38 -6 -12 16
3 5 -36 -3 -19 14 -2 -30 34 3 23 29 -6 35
-9 -39 -31 14 -33 4 -18 -22 40 -27 -10 36 10 29
-1 7 33 31 -23 20 0 -42 12 2 -31 -20 -16 9
26 -25 36 -3 19 -39 -7 2 -25 -33 -33 -7 19 28
21 0 -7 -35 18 4 -34 -2 -32 39 18 4 39 37
-28 7 26 -41 -33 39 -35 -31 -20 -27 -42 13 -19 34
32 -37 -36 -20 -31 -39 0 -35 -40 -42 -28 32 -37 9
-40 34 -29 28 18 -6 15 -2 -30 -33 16 -18 26 -9
-28 4 -39 39 -28 -6 -41 -41 -37 -10 0 20 18 12
