12
0 0 42
-3 -32 -41 2 3 -15 -29 32 28 37 6 41
38 31 35 0 -19 39 -7 2 -42 -5 -34 -21
-40 -30 -41 -4 -5 -15 39 10 -16 -22 -1 8
-6 -36 31 -36 -17 -7 34 13 15 31 5 38
-8 11 -19 -30 -23 -28 38 9 -4 19 27 32
0 -36 -30 13 -38 -22 28 32 -8 -32 -14 34
-39 -42 25 -18 21 -5 -28 -13 -15 -31 -33 16
37 29 37 16 5 39 14 -13 -41 -2 -24 22
0 34 4 -5 -15 17 0 24 -33 27 -18 21
27 25 40 -30 31 -1 -29 -28 10 21 20 18
-11 -30 -27 -25 -29 24 36 19 30 -24 -25 -6
6 30 -6 -41 -25 -12 -30 -26 0 -19 -15 30
