8
0 0 42
8 -32 -5 -1 9 36 -14 -12
41 -20 -39 -24 -16 35 27 6
33 -33 37 -5 -13 -18 7 38
1 -21 -12 -35 27 -5 -42 14
-19 -17 32 23 18 9 41 26
-9 2 41 39 1 -2 27 16
-16 38 -10 31 32 37 -36 2
37 38 -41 40 -35 -38 -20 -8
