19
0 0 42
-25 34 18 -6 40 -10 20 3 32 26 14 -28 41 4 -20 -37 -33 -7 -4
-7 39 -30 -21 -6 -35 31 5 23 -31 -32 -13 34 24 32 26 -26 -15 17
11 -36 -16 3 25 -8 -21 17 -34 25 10 7 41 20 -8 -33 -37 -30 16
-12 -10 -28 12 33 41 6 -19 31 35 4 21 28 -28 -6 4 24 -24 -10
-30 11 26 18 10 -28 6 -28 -35 -20 -38 -15 -33 -9 34 -34 6 30 8
-8 2 8 -5 1 8 0 4 2 -29 -18 -8 -21 -15 -6 25 3 -39 -42
28 31 0 36 35 -4 21 3 -21 33 21 -9 40 28 -18 -32 32 -41 19
3 -32 -13 14 13 22 -15 -30 29 -21 -36 -5 7 32 -42 39 34 -5 -18
16 -20 -32 2 -34 25 38 -31 -23 -25 36 27 -27 -8 32 3 2 -34 -13
21 35 22 -21 -12 -21 -24 -37 -32 23 36 7 -1 -36 2 -2 22 15 13
8 -41 5 -7 -1 37 25 -2 -31 -23 -26 -31 37 -22 -41 28 40 -22 -39
23 15 5 -16 -35 4 -39 -1 13 -11 -33 38 18 29 -3 -19 -3 -10 -26
-39 -12 -36 35 -28 -26 17 15 -34 8 2 37 -28 40 -24 -27 12 40 -15
-40 -35 38 35 23 8 -13 39 14 7 -15 -6 35 -19 -12 -22 15 -22 4
39 25 -17 31 20 5 -15 27 -36 7 10 -36 -34 12 13 -15 -18 24 -33
-42 -29 39 -22 -10 27 26 -17 -13 36 -15 34 -39 -5 -36 -33 -26 18 32
4 39 -1 -15 0 17 -31 0 -21 -36 -20 -30 -7 -5 4 32 27 -6 39
-11 -15 24 -13 15 -14 11 -20 9 -4 -6 8 16 -14 16 -20 20 26 -19
33 -16 -9 26 34 38 11 -6 32 -27 -40 27 21 -12 35 -39 16 8 7
