18
0 0 42
-33 10 -9 -13 -12 -27 -6 22 -8 13 4 22 5 12 34 -31 -42 33
-11 -15 28 32 6 -8 2 13 34 -19 -14 -6 -1 5 13 -14 -23 -29
-11 -42 -15 41 20 -7 13 1 -20 38 21 5 -6 -17 -36 40 -21 36
-19 29 -14 16 23 8 20 2 11 24 -22 1 26 41 -24 22 15 18
39 22 -33 -10 41 14 4 39 -38 -39 -33 19 37 -6 38 -34 -22 -2
10 -34 -31 39 22 -18 13 -38 -7 -14 -18 -35 13 -4 -31 15 0 -39
-9 -40 -7 -26 -26 -38 30 13 38 -33 -25 -36 -35 -22 -33 -12 12 24
-19 -11 -17 -37 5 36 6 22 39 -17 19 19 -16 -5 -30 8 -14 18
36 -42 3 -21 23 12 -33 31 13 -8 18 38 36 -28 -15 29 -4 -20
-42 -40 37 29 -3 -8 9 -25 18 -42 35 -21 1 -22 6 16 -14 30
13 15 -26 5 34 -7 -8 5 -36 -18 31 -23 -1 -33 -14 -35 33 40
-42 1 20 13 -20 28 12 -34 -6 -27 -5 -38 -18 -27 -2 32 14 37
-28 23 -21 33 3 -13 -25 -7 -13 20 -42 -1 -42 -13 -26 -9 -28 -40
-11 33 -11 -7 17 18 -27 25 -12 -41 -32 -29 38 26 40 36 17 17
37 32 4 14 -25 36 -2 22 21 -33 19 39 26 -22 31 14 16 20
-22 -20 -39 32 -16 -25 -27 16 12 -39 3 27 4 18 -35 -37 33 24
-2 -39 12 21 14 -26 -33 -1 -25 -17 -17 -33 -28 6 9 -34 24 17
-22 40 38 -13 -32 -9 -42 -41 31 -33 2 20 -10 23 35 -23 -9 16
