15
0 0 42
19 -20 -8 10 34 4 16 4 -29 -21 -24 21 22 -5 14
-19 30 0 17 -11 -35 -12 19 -22 40 -32 29 7 2 2
-5 23 -3 -34 -37 3 -27 -35 41 -3 -29 15 4 3 -9
-25 35 -30 -28 20 36 -41 27 35 -3 -26 -2 21 -27 -26
10 15 -31 20 -4 -42 -12 -35 38 -6 17 -28 -32 27 27
-8 24 0 24 17 -42 -35 36 -17 -26 -20 -9 -32 36 -16
-23 20 -24 20 -17 27 27 27 21 -37 -12 -31 -3 -2 -6
13 -22 13 -26 20 -6 -10 -22 38 -28 -32 -29 16 20 41
-25 -29 15 15 36 -15 -20 24 22 9 -16 15 9 -3 14
-18 8 25 -37 11 15 -31 13 -8 -29 26 -28 10 36 1
-33 3 -31 -20 2 9 36 -32 29 -28 23 -7 32 -9 30
-19 0 25 -6 -13 24 -31 7 -26 -26 17 -2 34 21 -26
5 32 7 -10 20 -23 35 -35 -17 -38 25 9 -14 -22 -22
-38 11 2 -18 23 36 -15 -4 -15 -30 -7 -9 16 27 9
-12 22 9 0 9 0 -40 37 -7 4 -11 3 -23 -31 -29
