12
0 0 42
18 -7 4 -42 -37 -15 41 41 -17 10 10 6
-6 38 -3 21 16 -5 33 41 1 32 -30 -20
11 -38 27 11 22 -11 4 16 -7 -40 1 -34
26 8 37 2 -29 20 -4 40 23 -16 -27 28
5 -25 4 23 24 14 21 -25 6 -25 25 34
2 -38 29 28 8 15 -34 -36 38 -5 40 -26
20 38 -21 21 -20 -13 9 39 0 -12 22 10
25 0 32 26 31 -30 -36 -40 9 18 23 -39
-24 -22 25 -20 35 -34 40 -34 9 25 27 -32
-5 19 -3 -31 40 -11 15 14 39 -7 -4 -35
41 -37 28 0 -23 14 -38 39 18 -38 18 -38
-6 9 27 28 4 24 -4 22 35 -16 5 35
